111111111111
1E0000000001
101111111111
100000000001
111111111101
100000101001
101110101101
100000000001
101111111101
100000000001
111110000001
111111111111
