N    ./textures/apa.xpm
S          ./textures/apa.xpm
W            ./textures/apa.xpm
E        ./textures/apa.xpm

C                0, 76,153
F          120, 120  ,120

11111111111111111111111111111111111111111111
1S000000000000000000000000000000010000000001
100000000000000000000000000000000010000000001
10000000000000000000000000000000010000000001
10000000000000000000000000000000010000000001
10000000000000000000000000000000010000000001
10000000000000000000000000000000010000000001
10000000000000000000000000000000010000000001
10000000000000000000000000000000010000000001
10000000000000000000000000000000010000000001
10000000000000000000000000000000010000000001
10000000000000000000000000000000010000000001
10000000000000000000000000000000010000000001
10000000000000000000000000000000010000000001
10000000000000000000000000000000010000000001
10000000000000000000000000000000010000000001
10000000000000000000000000000000010000000001
10000000000000000000000000000000010000000001
10000000000000000000000000000000010000000001
10000000000000000000000000000000010000000001
10000000000000000000000000000000000000000001
11111111111111111111111111111111111111111111