N    ./textures/apa.xpm
S          ./textures/apa.xpm
W            ./textures/apa.xpm
E         ./textures/apa.xpm

C                0, 76,153
F          96, 96  ,96

  
111111111111
1E0000000001
100000000001
100000000001
100000000001
100000000001
100000000001
100000000001
100000000001
100000000001
100000000001
111111111111

