N    ./textures/wolfenstein/nazi.xpm
S          ./textures/wolfenstein/blue_stone.xpm
W            ./textures/wolfenstein/grey_stone.xpm
E        ./textures/wolfenstein/red_brick.xpm

C                0, 76,153
F          120, 120       ,    120

11111111111111111111111111111111111111111111
10000000000000000000000000000000010000000001
11111111111111111111111111111111001000000000111111111111111111111111111111
                               10000000000000000000000000000000010000000001
11111111111111111111111111111110000001111111111111111111111111111111111111
10000000000000000000000000000000010000000001
10000000000000000000000000000000010000000001
10000000000000000000000000000000010000000001
10000000000000000000000000000000010000000001
100000000000000S0000000000000000010000000001
1000000000000000000000000000000010000000001
10000000000000000011100000000000010000000001
100000000000000001   100000000000010000000001
10000000000000000011100000000000010000000001
10000000000000000000000000000000010000000001
10000000000000000000000000000000010000000001
10000000000000000000000000000000010000000001
10000000000000000000000000000000010000000001
10000000000000000000000000000000010000000001
10000000000000000000000000000000010000000001
10000000000000000000000000000000000000000001
11111111111111111111111111111111111111111111
