N    ./textures/apa.xpm
S          ./textures/apa.xpm
W            ./textures/apa.xpm
E         ./textures/apa.xpm

C                0, 76,153
F          96, 96,96

  
111111111111111111111
100000000000000000001
1000000000000000000N1
111111111111111111111
